111111111111111111111111111
111000000000000000000E00111
110000000011111000000001111
1111110000000C0000000000001
100000000000000000000000001
10000C000000000000000011001
110000001110000001110000011
111000000C00000110000001111
11110P000000000000000001111
111111111111111111111111111
