11111111111111111111111111111111111111
10000000000000000000000000000000000001
10EF0000000001111111011111111111111101
100F00000011111111C0011110001111111101
100F00001111111PC00001000C001111111101
1000011111111C000000F00000001111111C01
1001111111C0000000000000011111111F0001
10111111C0000F000000000111111100000001
101111CCCCCCC0CCCCCC011111110000F00001
10111111111111111111011111110F00011101
10111111111111111111011111110001111101
10000000000001111111011111111111111101
100C000F00000111111100000000000F000001
10000000000C000000000000000C0000000001
11111111111111111111111111111111111111
