111111111111111111111111111111111111111111111111
1110000000000001111111111000000000P0000F00000111
110000000011111000000001111000111000000011000011
1111110000000C000000001FC0000C00001C000000000011
10000000F00C00000000000F000000F00000000000000011
10000C00000000000000001100000000000000000111C101
110000001110000001110001111000000C00000000000011
10000C000000000000000011000000000000111111111111
10000000F00C000000000000010000000C00000111000111
10000C0000000000000000110000000F0000000000000C01
10000000F00C00000000000F000000000111000000100011
10000C000000000000000011000000011110000110F00001
110000001110000001110000111100000000011100000011
110000001110000001110000000000C11111111111100011
111000000C00000110000000000000000000000000001111
11110E0000000000000F0000000000000000001110001111
111111111111111111111111111111111111111111111111
