111111111111111111111111111
111000000000000000000P00111
110000000011111000000001111
1111110000000C0000000010C11
100000000000000000000001011
10000C000000000000000011001
110000001110000001110000011
111000000C00000110000001111
11110E000000000000010001111
111111111111111111111111111
