111111111111111
111000000E00111
110000000001111
1111100000110C1
1000C0000000011
111000000C00011
11110P000000011
111111111111111
