111111111111111
111000000E00111
110000000001111
111110000011001
1000CF000000011
11100F000000011
11110P000000011
111111111111111
