1111111111111111111111111111111111111
1000000000000000000000000000000000001
10E0000000000111111101111111111111111
100000000011111111C001111000111111111
1000V0001111111PC00001000C00111111111
1000011111111C000000000000001111111C1
1001111111C0000000000H000111111110001
10111111C0000000000000011111110000001
101111CCCCCCC0CCCCCC01111111000000001
1011111111111111111101111111000001111
1011111111111111111101111111000111111
1000000000000111111101111111011111111
100C00H000000111111100000000000000001
10000000000C011111110000000C000V00001
1111111111111111111111111111111111111
