1111111111111111111111111111111111
1E0000000000000C00000C000000000001
101001010H100000101001000000010101
1010010010101010001001000000000111
1P0000000C00C000000V00000V01000001
100000V00000H00C00000C000000000001
1010010100100000101001000000010101
101001001010101000100100000101H111
100000H00C00C00H000100000001000001
1111111111111111111111111111111111
